########
###  ###
### $###
## .$  #
##.. . #
##$.*###
#  $@###
#  $####
#   ####
########