#######
## . ##
## . ##
##$ $ #
## .. #
## $ ##
# .* ##
#  $.##
## $$##
###@ ##
#######