#########
##  * ###
##    ###
## #  ###
## $ ####
#.$*$####
#   +####
### .####
#########