########
####  ##
## $  ##
# $    #
#@*$## #
##. $..#
##  .###
###  ###
########