########
###  ###
### $ ##
#   * ##
# ##.  #
# * $. #
##$# @##
##.   ##
########