########
#.  ####
# #$####
# #   ##
#..* $##
# # $  #
#  # # #
##  @  #
########