########
###  ###
###  ###
###  ###
#    ###
#  $.$ #
##.#$#@#
##.  $.#
########