#########
##  . ###
##$ $@###
#  #*.###
#  . $###
# $  .###
### #$###
###.  ###
#########