########
##. $ ##
#    $ #
# .$#+ #
### $ .#
### .$ #
###  ###
########