########
### .. #
###  $*#
#.$ . .#
# #$ $ #
#@$ # ##
##    ##
########