########
#     ##
# #    #
#.$ .# #
# # .$ #
#.$$####
## @####
########