########
########
##    ##
# $ *.##
#@$.$  #
## * . #
###   ##
########