########
##@ ####
##$*   #
## $* .#
#  .$  #
#  *.$ #
#### . #
########