########
#    ###
#  $ ###
## ..###
# $* ###
#  .*$@#
##   * #
########