########
##### .#
# $  $ #
#    *@#
## .**##
### $. #
###    #
########