#########
###  ####
### $  ##
# @$*..##
# $.   ##
### #. ##
### $ ###
####  ###
#########