#########
###.  ###
#   . ###
#  $ ####
#.*.. ###
# $ $ ###
#$#$#####
#@  #####
#########