########
#   ####
#.$.####
# . $  #
##$..  #
#  $$###
# .$@###
#  #####
########