#########
###   ###
##    ###
## # ####
#  . .###
# $$$ ###
##+ #####
##  #####
#########