########
##.@ ###
##$# * #
## # $ #
##  * .#
#   $  #
# . ####
########