########
####  ##
# $ $.##
# $ $.##
# # .$##
# # .. #
#+$    #
########