########
# @ ####
#$     #
#  #** #
#.$. $##
###    #
#### . #
########