########
##  ####
##.   ##
#...$ ##
# # #.##
# $ $ ##
## $$###
## @ ###
########