#########
##  #####
##  *.$+#
##  . $ #
####  ###
####$ ###
####  ###
####  ###
#########