######
#    #
# * @#
# * ##
# *$#
# . #
# .$#
#   #
#####