########
#  #####
#    ###
# . *###
##$*.  #
# .$   #
#  *$###
### @###
########