#########
## @#####
##$$..###
## * * ##
## # ..##
#  $ $ ##
#    ####
#  ######
#########