########
## .   #
##$  $.#
##  #$ #
# .* *$#
# .  *@#
#  #####
########