########
####.@##
## $ $ #
# . * .#
#  $# $#
###.   #
####   #
########