########
###  ###
###. ###
##  $$ #
##$.   #
##.$.###
# . .###
#  $$###
### @###
########