#########
###  ####
#    ####
#* $ ####
#@#$.####
# .$*####
#  . ####
#  ######
#########