########
### @ ##
#  $#$##
# #   ##
#   #$.#
##. *  #
## ..$ #
########