########
#  #####
# $  ###
# * $  #
# ..*@ #
#  *$###
## . ###
###  ###
########