#########
# .   ###
# $  .###
##.#$ ###
##  $ ###
## # $###
##$#.@###
##  .####
#########