######
###  #
#    #
# .$.#
## *.#
#@$* #
# $  #
##$. #
##  ##
######