########
##  ####
## .  ##
##.$*$.#
##$  # #
#   ##@#
# .  $ #
#  #####
########