#########
##  #####
##$ $ ###
##. . ###
#@$#  ###
# $ .  ##
#### # ##
####.  ##
#########