########
####   #
##@$$$ #
##$*.* #
#  * * #
#  ... #
###    #
########