########
###@ ###
###  ###
##   ###
##  *###
###.  ##
###.$$##
### $. #
####   #
########