#########
###  ####
###  ####
#.@$ $ ##
# #$...##
# $  $ ##
##### .##
#####  ##
#########