#########
##  @####
## $$####
##$.* ###
# $.  ###
# . # ###
# .$. ###
##  #####
#########