########
#    ###
#  #$###
#.$#   #
#. .$# #
# $. $@#
###.  ##
########