########
#### @##
### *$##
### *. #
# $ $  #
#  .* ##
#   . ##
########