 #####
 #   ##
 # .  #
## *  #
# $* ##
#  @##
#####