#######
##@ ###
##$ ###
## $###
##  ###
## $###
# $ ###
#.  ###
#..   #
# .$. #
#######