#########
##  #####
## .#####
#   $@###
# *$*$###
# . $.###
#  #$ ###
#  .. ###
#########