########
####  ##
# $@$ ##
# ##*.##
#.  $ ##
#  $ .##
### . ##
####  ##
########