########
###  ###
# .. ..#
#  $ # #
## # # #
## $ $ #
###@$ ##
###  ###
########