########
####  ##
###   ##
### $ ##
#   $ ##
# ## $##
#.*. .##
### @ ##
########