#########
#####  ##
#####$.##
#@ $ $  #
# $   . #
####. ###
####.$###
####  ###
####. ###
#########