########
#  *@###
#  $ ###
# *.$###
# * * ##
#  *.  #
# *    #
########