########
##  ####
## . ###
## .$###
## ..###
# **$$ #
#@$    #
####   #
########