#########
##  #####
## $@####
#  *$####
# ...####
#  $$ ###
#  #  ###
##.  ####
#########