########
###    #
#    $.#
#  ## .#
## ##*.#
#  $@$ #
#   ####
########