#########
#### .###
## @$ ###
# *$. ###
#.   $###
# #$. ###
# $ #.###
##    ###
#########