#########
##   ####
##@#$####
##$  ####
# *. ####
# #$   ##
#  ..# ##
####   ##
#########