########
####@ ##
##   $##
## #. ##
##   $##
####.$ #
####  .#
########