#########
###.. ###
#.$.$ ###
#@$  ####
##$#  ###
##    ###
## #  ###
##   ####
#########