#######
#  ####
# . ###
# ..*@#
# $$* #
#*  $ #
#  $  #
#### .#
#######