########
##  ####
##$ ####
#     ##
# $$ . #
###@** #
###*. ##
### . ##
###  ###
########