########
##    ##
##$  . #
# .*.  #
#  $. ##
###$$###
###@ ###
########