####
#  ##
#  .#
#  .#
##$##
# @ #
# $ #
#   #
#####