########
####  ##
# . .  #
# # *.*#
#  $ $@#
#  $$# #
####  .#
########