#########
###  ####
###$ $ ##
#   .#@##
# .$.* ##
###   ###
###  ####
###  ####
#########