#########
### +..##
# . .# ##
#  $$$ ##
###  $###
###   ###
#### $###
####  ###
#########