#######
###  @#
## $$ #
##.* ##
## $ ##
# .$.##
#  * ##
## . ##
##  ###
#######