########
##   ###
## #. ##
##$.   #
##@$**.#
# $$. $#
#  .   #
########