########
##.@ ###
#  #$###
# .*   #
# $    #
## #$###
##.  ###
########