#######
###   #
#  $..#
#.. .$#
# $$$ #
### @##
###  ##
#######