#######
#.    #
#     #
# $   #
#     #
#  $  #
#    .#
#@    #
#######
