##########
#        #
#  ####  #
#  #  #  #
#  $  $  #
#  .  .  #
#  #  #  #
#  ####  #
#@       #
##########
