########
#  #####
#  #####
#    ###
## ... #
##$* $ #
# $.####
#@$ ####
#  #####
########