########
###  ###
# *$  ##
#@$. . #
# $**  #
## .$ *#
## .   #
########