########
####  .#
####   #
###..$.#
### #$ #
###  $$#
#####@ #
########