#########
##  #####
##. #####
#   $ ###
#..$ .*@#
# $ $ $ #
#. ######
#  ######
#########