########
#     ##
# $$.*@#
#* .*# #
#  ..$ #
### $  #
#####  #
########