########
###  ###
## * ###
# .. $.#
#    # #
## #$$@#
##    ##
########