########
#####  #
### $. #
# $  * #
#. **  #
#@$..$ #
###   ##
########