########
#### . #
##@$. $#
##$ #$.#
## * . #
# .$ $ #
#  .  ##
########