########
### @###
### $###
###$ ###
#  . ###
# **  ##
## .. ##
## $ * #
####   #
########