########
####  ##
#### .##
##  $  #
##  *.$#
#### * #
####$ .#
####@  #
#####  #
########