#########
####  ###
## .  ###
# $# .###
#   * ###
##@#* ###
##  $ ###
####  ###
#########