########
#####  #
##  #  #
## .*  #
#   # ##
#  ## ##
# $@$ ##
#### .##
########