#########
#  ######
#   .####
#.  @####
##$#*  ##
## $   ##
##  #####
##  #####
#########