#######
# $+ ##
#  $$##
#. * ##
#.. . #
# $$  #
#  ####
#######