########
#####  #
###  $ #
## . * #
# ** * #
#@$    #
##### .#
########