########
###  ###
##  .*+#
## $$  #
#   ##.#
#  $# .#
##  $ ##
##  ####
########