########
###@ ###
## $*  #
# $ $ .#
# .*. .#
### $# #
###    #
########