########
###  ###
###. ###
##  $  #
## ..  #
## * ###
##*$$###
#  $@###
#.  ####
########