########
# @#####
# $  ###
#  #. .#
# $$  $#
# $ #  #
### ...#
########