########
##  ####
##   $+#
#   ## #
# * .# #
### $$ #
### . ##
####  ##
########