########
##    ##
##.   .#
# *$#.$#
#@$  $ #
### $..#
#####  #
########