########
##  ####
## *@###
## *$###
## . ###
#. $*. #
#  $   #
###  ###
###  ###
########