########
###  ###
### $###
#  $. .#
# .$.  #
### .$ #
#### $ #
#####+$#
#####  #
########