#########
###@ .###
###$# ###
### **. #
###     #
#  $ ####
#    ####
##  #####
#########