#########
#..######
#.   ####
# $# ####
##   ####
##$# ####
#@ $  ###
# *   ###
#########