#########
###@  ###
##    ###
## .*$###
### *.$ #
### $   #
####. ###
####  ###
#########