#########
##  #####
##   ####
#. * ####
#  .$####
### $ ###
###.$@ ##
####   ##
#########
#########