#########
###  ####
## $ ####
## . .###
#. $#   #
#   $   #
###*#$###
###+  ###
#########