########
#      #
#  ..  #
#      #
#  $$  #
#      #
#@     #
########
