########
###  . #
###* $$#
#@ $  .#
# # *$ #
#.  . ##
###  ###
########