########
###  ###
#   .###
# $$   #
##.*.  #
# ** ###
#@$  ###
###  ###
########