########
#  #####
# .#####
# $#####
#. $ ###
# $. ###
## *$ @#
## . * #
##   ###
########