#########
####  .##
### $# ##
#  $@$.##
# . $# ##
## . . ##
### #$###
###   ###
#########