########
####  ##
#@* .$ #
#$$$.. #
#.*..  #
#  $$  #
#   ####
########