########
###  $+#
##   $ #
## .#$.#
##.   ##
## $.$##
####  ##
########