#########
###  ####
###. ####
## $$  ##
# .*.  ##
#@  $####
## # ####
##   ####
#########