########
####  ##
##.@$ ##
# $.$ ##
# .# $ #
#$     #
#. .####
########