########
##  ####
## .####
## * ###
##   ###
## .*  #
#@$**  #
# $  ###
###  ###
########