#########
#  ######
#.   ####
# * .####
# #$$ ###
# $@# ###
#  $..###
#. $  ###
#########