########
##@.$.##
##$$ . #
# .#   #
#   $  #
####  ##
####  ##
########