########
##@   ##
# $$*.##
# .#   #
##     #
##.$ ###
##  ####
########