########
##  ####
##   $@#
#  $##.#
#   ##.#
## $$  #
##  .*.#
###  ###
########