#########
##@ #####
##$* .###
## *.$###
## $  ###
#  #. ###
#.$   ###
#   * ###
#########