#########
####. ###
####$@###
# .$ $. #
#    $  #
####  ###
####* ###
####. ###
####  ###
#########