########
## .$.##
## $ . #
##.#   #
##@$$  #
####  ##
####  ##
########