#########
##    ###
##*  .###
#@* #.###
# $ $ ###
# #$..###
# $  ####
###  ####
#########