#########
#### .###
##@$ .###
##$#. ###
## #. ###
#   $ ###
# $#* ###
#     ###
#########