#########
### @####
###$$  ##
### $#.##
#  *.  ##
#  $  .##
### .####
###  ####
#########