########
###   ##
## $ . #
# ..$$.#
#  $.*$#
# .$ *@#
###   ##
########