########
#####@ #
### .$ #
#  $# .#
#  . * #
## #$  #
##   ###
########