#########
#   #####
# . #####
##    ###
##.*# $ #
##. $   #
## $#$###
###.@ ###
#########