########
##  ####
##   ###
##$  $@#
#.   # #
#  $ *.#
###$##.#
###   .#
########