#########
###  ####
###  ####
###  ####
###$ ####
#  $*+  #
# . .$  #
### * ###
####  ###
#########