#########
###.  ###
###*#@###
## .#*  #
##  $   #
## $ ####
#    ####
#   #####
#########