######
#@ ###
#*$  #
# $  #
# $ ##
#. $##
#  $.#
#  ..#
### .#
######