######
###  #
###  #
###@*#
###$ #
#  $.#
#  * #
## $.#
## . #
###  #
######