#########
##.  ####
## #$####
#   $ @##
# *. $ ##
## . ####
###  ####
###  ####
#########