#########
###  ####
###.$ ###
##. $ ###
##$# . ##
#  $$  ##
#@$. .###
### . ###
#########