#########
#   #####
# .$.  ##
##$ $ .##
##@#$ $##
## * . ##
####  ###
#### .###
#########