#########
####  ###
###@* ###
###$$  ##
# . .# ##
# . #  ##
##$   ###
##  #####
#########