########
##@ ####
## $####
##$ ####
##    ##
##$.*. #
#.  *  #
# $. ###
###  ###
########