########
### @###
### $###
# .$  ##
# .$.* #
##     #
# .$####
#   ####
########