#########
### . ###
#  *  ###
#.$.. ###
#.$ #$ ##
#$$*   ##
#@*    ##
#########