########
## $  .#
# $  # #
# #$  .#
#@ $ #.#
### # .#
###   ##
########