#######
# $ .##
# .  ##
#..$* #
# * $@#
#  $###
#   ###
#######