#######
###  ##
###   #
###$  #
# $...#
#@ $$ #
###$.##
### .##
###  ##
###  ##
#######