#########
###  ####
#..  ####
#    $ ##
# #$ $+##
# #  ####
# #$#####
#.  #####
#########