########
####@ ##
#### $##
##  * ##
## ** ##
###  . #
###.$  #
###  ###
###  ###
########