########
####  ##
##     #
# ..$$ #
# **+###
##  $###
##   ###
###  ###
########