#########
#########
###  ####
#   .####
# #$. . #
#  $    #
##$#$####
##  +####
#########