########
#### .##
#.    ##
#$$#. .#
# $@$  #
#  #####
#  #####
########