#########
#   #####
# #$ @###
# # $$###
#. ...  #
### $$  #
####. ###
####  ###
#########