#########
##   ###
##    ##
#. #  ##
# ##$ ##
# $   ##
#*** .##
# @#####
#########