#########
##  #####
## . ####
# $.$####
#.**   ##
#   $  ##
# $# ####
##.@ ####
#########