#######
##@ * #
##*$  #
## *. #
#  $$*#
#..$  #
#   . #
#######