########
##  ####
##. .$+#
##   # #
###$$  #
###  *##
###   ##
########