########
###  ###
###@$###
#  $. ##
#  *   #
## # . #
##$##. #
##    ##
########