#########
##  #####
## .#####
#  $ ####
# *..$@##
#  $$$ ##
#. # ####
# .  ####
#########