#########
##@ #####
##$$  ###
##.$. ###
## #  ###
#  .* ###
#  #$####
# .  ####
#########