########
#  #####
#  @ ###
#  # ###
##.#$  #
#  $   #
#  .####
########