#########
#  ######
# .  ####
#   .####
# #$ ####
#. $$####
# *$+####
#  ######
#########