########
##    ##
##.#$ ##
## #. ##
#@* $$##
#  # . #
##     #
########