########
### $. #
### . .#
#@ $$$ #
# * . .#
##  $$ #
#####. #
########