#########
###. ####
###$ ####
#@  * ###
#$#$$ ###
#. $. ###
# #   ###
#.  . ###
#########