#########
## .   ##
#  $*  ##
#  *. ###
##. $####
##   ####
##$#$####
##+  ####
#########