########
#  #####
#   ####
#. $####
## * ###
## . ###
## .$$ #
##$. *@#
##   ###
########