########
###   ##
###$.*##
# $    #
#@$$.# #
##*   .#
## .  ##
########