########
###  ###
###  ###
##   ###
## . ###
## *$$@#
##$. * #
#. $ ###
#  .####
########