#######
##@.  #
# $$ $#
# * *.#
#   * #
### . #
####  #
#######