#######
#   ###
#   ###
#$*   #
# .$.*#
#. $* #
###@  #
#######