#########
####  ###
### * ###
# ..  ###
# $$$ ###
##@#   ##
##*#   ##
##.  ####
#########