#########
#   #####
# # #####
#.$.$ ###
#    .###
#..#$ ###
# $$@####
#  ######
#########