  ######
  #    #
  # ## #
  # $  #
  #  *##
### *+#
#  $.$#
#   . #
#######