######
##  ##
#   ##
#  $##
#.. ##
# ** #
# *  #
#$ * #
#@*  #
######