#########
###  .###
###$# ###
#  $ * ##
#  ..  ##
###$.  ##
### $####
### @####
#########