########
#  #####
#      #
#. .*$ #
### . ##
###**$ #
###@$  #
#####  #
########