######
## @##
## * #
# $  #
# .*.#
#  $ #
#*.$ #
#  $##
# . ##
######