########
#### .##
##@$ $ #
##$* . #
##   $ #
#  * * #
# .. * #
########