#########
####@ ###
##  . ###
# $#$ ###
#  $.####
## $. ###
## .  ###
## $. ###
#########