########
###   ##
#@$   ##
# $$  ##
### #.##
### #.##
###  .##
########