#########
###@ ####
###$$####
#  $  ###
#..$. ###
#   # ###
# # $.###
#.   ####
#########