########
#   ####
# #$  ##
#     ##
# ## ###
# .*  ##
#$#$ .##
#+  ####
########