#########
###  ####
###. ####
# @$$$ ##
# #    ##
# #.$####
# #. ####
#.   ####
#########