#######
#@.  ##
#$$$$##
# .. ##
#.$.$ #
# .$$.#
#  .  #
#######