########
#  #####
#  $ ###
# $.   #
## .$. #
##$.$###
## * ###
###. ###
### @###
########