########
####  ##
##    ##
## $$$@#
# * #  #
#...*$.#
#    * #
########