#########
####  ###
####  ###
#### .###
####    #
##@$.*. #
# *$$  ##
#   #####
#  ######
#########