########
#  #####
#. .####
#  $####
## $ $ #
##...$@#
## $$  #
## .####
##  ####
########