#########
#####@ ##
#  .$. ##
#.  .$ ##
## #*####
##$  ####
## $ ####
##   ####
#########