#########
#####+  #
##  **$ #
# . .  ##
#  $# ###
###   ###
###$# ###
###   ###
#########