#########
##  #####
##* $ ###
##. ..###
## #  ###
# $$. ###
#@$  $ ##
#### . ##
#########