########
###  ###
###  ###
##@$.  #
##*$*..#
##.$   #
##  ####
# $ ####
#   ####
########