#######
##  ###
##  ###
#   ###
# .$###
# * $ #
#$.$*@#
#.  .##
###  ##
#######