#########
###   ###
###.. ###
### $ ###
### $$  #
### *.  #
###$* .##
### @####
#########