########
#  .$ ##
# #$$@##
#.  $###
#.#  ###
#.##  ##
#     ##
####  ##
########