#######
###  ##
## . ##
## .$##
## *. #
#  $. #
# $ $ #
##@ ###
#######