########
###  ###
### *@##
#   *$ #
#*  .$ #
# $* . #
# .  ###
########