#########
###   ###
### # ###
###    ##
# $*.. ##
#@$   ###
###$.####
###  ####
#########