########
####   #
#  $.$ #
# ..*..#
#.$$$  #
#  $@* #
##  ####
########