#########
#  ######
# * #####
#.  #####
# .  ####
#  $ ####
#$#$#####
# @.#####
#########