#########
####  ###
####. ###
#    $$ #
# ..*  .#
### $   #
###*$####
### @####
#########