########
##  ####
##    ##
## *$. #
## $   #
##$. ###
# $*####
#+ .####
#  #####
########