#########
#  ######
#. @ .###
#*.#$ ###
# $  $###
#.#   ###
#   $####
###  ####
#########