#######
##  ###
## . ##
##$* ##
##    #
# $$$.#
#..*  #
# @$. #
#######