#########
###  ####
### . ###
### $.  #
###  *. #
#  $ $ ##
#  **$###
### + ###
#########