########
##  ####
## .  ##
#. $# ##
#  . *##
## #$$ #
##    @#
########