########
####  ##
##. . ##
##  * ##
###$*$+#
###  $ #
###  ###
###  ###
###  ###
########