#########
###  ####
###  ####
#@$  ####
# $#$####
## .  ###
## .  ###
## .#####
#########