########
### @###
###  ###
###$$###
#   .  #
# $*.* #
## .. ##
###$  ##
###  ###
########