#########
#   $.###
#+ $# ###
# $   ###
# $$#.###
###  .###
### # ###
###  .###
#########