########
### .@##
###$* ##
# * *$ #
#    . #
#.#$  ##
#    ###
########