#########
####@ ###
##  $$###
# ..  ###
# $ * ###
## #$ .##
##. $. ##
#####  ##
#########