#########
##@ #####
##$$. ###
##.$. ###
## #  ###
#   . ###
# $.$ ###
##  #####
#########