########
##  ####
##$.####
## .  .#
##$. # #
# $ ## #
#@$    #
#  #####
########