#########
##    ###
## $#.###
##    ###
### # ###
# $$#* ##
#     +##
##### .##
#########