########
###  ###
###$@###
# $ $ ##
# # # ##
#.    ##
### #.##
###  .##
########