#########
### @####
# $$$####
#..*  ###
#    *###
# .# .###
## #$ ###
##    ###
#########