########
#    ###
# . .* #
## $   #
### .$ #
###$.$##
### * ##
####@ ##
########