#########
### ...##
###$.# ##
# $    ##
#@.$$ ###
###  $###
####  ###
####  ###
#########