#####
#   #
#@$.#
#   #
#####
