#########
### @####
###$*####
#  $ $ ##
#  * #.##
### .# ##
###    ##
###   .##
#########