########
##  $ .#
##.    #
####..##
#### $##
####  ##
#### $##
####$@##
####  ##
########