######
## + #
##$.$#
## * #
## * ####
## * ####
## $. ###
# $.   ##
#   .$* #
####    #
#########