########
### . ##
#.$  $##
#  .*$ #
#    $+#
### * ##
###  ###
########