########
###@ ###
###$ ###
#   $$ #
# #    #
#...$###
# ## ###
#.   ###
########