########
## @ ###
## $$###
###$ ###
###  ###
#.$.$  #
#  . . #
#  . ###
########