#########
#########
##@   ###
## $#.###
## .# ###
## $$.###
# * # ###
#     ###
#########