#########
###  ####
###  ####
# $$.   #
#@#. *. #
# #$  ###
# $. ####
###  ####
#########