 ####
##  ###
# $   #
#  ## #
#     #
##$## #
## ## #
#  ##.#
# ## +#
#    ##
######