########
### . ##
#@$$  ##
# * . .#
###$#$ #
###    #
### ## #
###   .#
########