########
#  * ###
#  . ###
#  $$$@#
## . * #
##$. ###
## . ###
########