#########
#### . ##
#### $ ##
## ...###
##$   ###
# $ #*###
# $   ###
# @######
#########