#######
####  #
###  .#
#   $ #
# *.$ #
# *.$ #
##@* ##
##  ###
#######