#########
#  ######
#  @ ####
# $ *####
##$# ####
# $. ####
#  . ####
## . ####
#########