########
#  *@###
#  *$###
# .* $ #
# $*   #
#  .. ##
# *  ###
########