#########
###@ ####
#.$.$####
#  $  ###
#. # $###
#$  $.###
#.  # ###
###.  ###
#########