########
###   ##
## $.$ #
# *.  .#
#@.** $#
# $*   #
#   ####
########