########
#### @ #
#   $$ #
#. $# ##
##$ *  #
##  . .#
##### .#
########