#########
#####   #
####    #
####  $##
####$. ##
###+$.###
### $ ###
###. ####
#########