########
##  . ##
# $.$$##
#  # *@#
# $  $ #
# .. ###
###. ###
########