#########
### @####
###*$  ##
#   $  ##
#  .*# ##
### . .##
### $####
###  ####
#########