  ####
###  #
# .$ ###
#. $$ @#
#  . * #
# $# ###
##.  #
 #####