########
##  ####
## * ###
##   $ #
## $$+ #
#. * ###
#  * ###
###. ###
###  ###
########