########
## + ###
##$.$###
## * ###
## * ###
## * ###
## * ###
#  $ ###
#  *  ##
## . * #
###    #
########