########
#### @##
## $$$ #
##.* * #
# $    #
# .. ###
## . ###
###  ###
########