#########
###  ####
#    ####
# #  ####
# #.#####
# $$$ ###
## . +###
##   ####
#########