########
#@  ####
#  $$ ##
# $ ..##
## #**.#
#      #
#   ####
########