#########
#  ######
#  ######
#   #####
#$  #####
#@$  ####
#*$# ####
#. ..####
#########