########
###  @##
#  $$$##
#..*.  #
# $$.$ #
# . . ##
# $. ###
########