#########
###  ####
#    ####
# $$ ####
##$@$ ###
# .#  ###
# .. ####
#. ######
#########