########
##@. ###
## .* ##
## *.$##
##$#   #
#  $$  #
#   . ##
########