#########
##  #####
##  #####
##$ #####
##  #####
#   #####
# #$  ###
#...$@###
#########