#########
###  ####
###  ####
#  * $  #
#  ** . #
###  # ##
#### # ##
#### @ ##
#########