#########
###  ####
###    ##
#  $ $ ##
#.# $####
#..* ####
#+$  ####
###  ####
#########