#########
##   ####
##.$*  ##
##.$   ##
## #$####
# . @####
# ## ####
#    ####
#########