########
####. ##
#    $##
#  $ . #
## .*  #
# $*$###
#@ . ###
########