########
##@ ####
##$ ####
## $$ ##
#  $  ##
#  ## ##
#.  .  #
#### ..#
########