########
###  ###
##.$ ###
## # ###
# $ $  #
# ..   #
## @ ###
########