#########
#  ######
# $  ####
# . . ###
##$*  ###
##@$. ###
##$# ####
##.  ####
#########