########
##  ####
## . $.#
## .##@#
##$.## #
#  *$  #
#  $ ###
#    ###
########