########
##  ####
# . $  #
#. *  *#
#  $*. #
##$$   #
##+ ####
########