########
###  ###
#. .$###
#  *@###
##$.$###
#  $. ##
#   $  #
#### . #
########