#########
###  ####
##@$  ###
##$ #.###
## *# ###
## $ .###
# . # ###
#     ###
#########