########
##   .##
## ##.##
# $ #.##
#    .##
# $   ##
##$$####
##@ ####
########