 ####
 #  ###
 # $  #
##.## #
# .$  #
# +   #
# #$###
#   #
#####