########
##  ..@#
##$*$  #
## . ###
#   $ ##
#  #$ ##
##  . ##
########