 #####
 #   #
## + #
#  * #
#  * #
##$* #
 #   #
 #####