########
###   ##
#   #$##
#.. # ##
# $ .  #
#$$#$  #
#+ . ###
########