########
####  ##
####.$##
#.$  . #
#@##$  #
#$   # #
# .  $ #
# .#####
########