#########
#### . ##
## $ $ ##
#. . .###
# #.$ ###
#   $####
###$ ####
###@ ####
#########