########
#####  #
### .$.#
### .  #
#### $##
####$ ##
####@ ##
####  ##
####  ##
########