######
# .$ #
#.*$ #
#. $ #
#. $@#
######