#######
## .$ #
##  *@#
##$$ ##
## ..##
# . $##
#  $  #
### . #
#######