########
##  ####
##  ####
## $####
##  ####
## $@  #
# $# # #
#  .. .#
########