########
###  ###
###  ###
# $   ##
# # # ##
#.  ..##
##$$####
##@ ####
########