#########
####  ###
### .$###
##  . ###
##  . . #
##  * $ #
####$$###
#### @###
#########