########
#   ####
#  *.  #
##  $  #
###$* ##
###@* ##
###$.$##
###  .##
### . ##
########