########
####@. #
## $$$ #
# .*.$##
#  $.  #
###  . #
###  ###
###  ###
########