#########
####@ ###
#### $###
## $$ ###
#   $.###
# . # ###
##. . ###
##  #####
#########