########
#### @##
#   $$##
# $.# ##
## . .##
## $ . #
####   #
########