########
#  #####
#. #####
#  $ $ #
#... . #
# $.$###
##   ###
###$$###
### @###
########