#########
##  #####
##    ###
#. .# ###
#$#$  ###
# *. ####
#  #$####
# @  ####
#########