########
###@ ###
##     #
# *$ #.#
#  *$ .#
## .$#$#
## .   #
########