########
#. ..###
# #  $@#
# $ $  #
#.## ###
#  $ ###
###  ###
###  ###
########