########
########
##@  ###
##$$ $ #
## ##  #
#  #   #
#  .. ##
####. ##
########