########
##  ####
## $ $ #
# ..# @#
#. *$*.#
# $ .$ #
#    ###
########