########
#   ####
#  $####
## .$@##
##..$*##
## ..  #
## $ $ #
###   ##
########