########
##@ ####
##$$  .#
## .* .#
## ## ##
## ## ##
# $   ##
#     ##
########