#########
###  ####
###  ####
#  $.*  #
#  *. # #
###     #
####$#$##
####.@ ##
#########