########
###   ##
# .$ *@#
#  $.*$#
# ..*$.#
## $   #
###   ##
########