########
###  ###
###  ###
### $###
###$.###
# $@*  #
# .$.  #
### .  #
####  ##
########