 #####
## . #
## .$#
## . #
# .$ ##
#  *$@#
# * $ #
# *  ##
######