#########
### @####
### $####
#  $  ###
#  $  ###
##$#  ###
# . # ###
#...  ###
#########