#########
#  ######
#    ####
# .#  ###
##.*$ ###
# $ $ ###
#. *#$###
#@   .###
#########