########
###  ###
###  $@#
### .# #
##  $$ #
##. . ##
##  ####
########