######
##   #
##.$.#
# * .#
#$ . #
#+$* #
# $  #
## $ #
###  #
######