######
#  ###
#@*  #
#$ $.#
#. *$#
#$.. #
# $ ##
#.  ##
#   ##
######