#########
####@ ###
## $ $###
# *.$ ###
#   # ###
#  .$.###
## ## ###
##.   ###
#########