########
####  ##
####  ##
####   #
####$  #
###  +##
###*$.##
## .$ ##
##   ###
########