########
###@ ###
###$ ###
# $   ##
# #$. ##
#.  . ##
####  ##
########