########
####  ##
###@* .#
###$# *#
# $  $ #
#    ..#
###    #
########