########
####  ##
####  ##
##  $$ #
##.+* .#
## $ # #
####   #
########