#########
######  #
#####@* #
#### *  #
## .$.  #
##  $.$ #
####  ###
####  ###
#########