#########
###  ####
###  ####
# $ $ ###
#..$$   #
#+# $   #
#.# #####
#.  #####
#########