########
###  ###
#.  $###
#     .#
###$$. #
### . ##
###$* ##
###@* ##
####  ##
########