#########
##  #####
##   ####
#  .$####
# #*$ ###
#.    $@#
### .*# #
#####   #
#########