########
#  #####
# $. $ #
# . *  #
#  **  #
# . *$##
#### @##
########