########
##  ####
## . ###
# *..$ #
#  .$ @#
##$ $###
## * ###
###  ###
###  ###
########