   #####
####   #
#  $   #
#  .#* #
## . . #
 # $$#$#
 ### @.#
   #####