########
###@ ###
#  . ###
# *$$. #
## . $ #
###.$ ##
### $  #
#### . #
########