########
#  . ###
#   .  #
##*$   #
#  $#*##
# .$@ ##
#  #####
########