########
#  #####
#  .. ##
#  ##$##
## ## @#
##  $$ #
##. $ ##
## .  ##
########