#######
##  ###
# .$###
#.. ###
# $   #
# *.$ #
#* $$ #
#  + ##
#######