########
#   ####
# $   ##
### ** #
###$   #
#@  $* #
# ... ##
########