########
#  #####
# *  $ #
# $..$.#
# . *$ #
# .$*  #
####@  #
########