########
#### @ #
##  $**#
##   $ #
####$* #
##   . #
## . . #
########