#######
#  ####
# $  ##
# . * #
## *  #
##.$* #
##$@.##
##   ##
#######