#######
###@ ##
### $##
###$ ##
###  ##
# $$  #
# # . #
#..$. #
### . #
#######