########
##   ###
# *.$  #
# .. ..#
# $ $  #
# $*$###
#  *@###
########