########
###  ###
#   * ##
#*  * ##
# $*. ##
#  *$* #
#  .@  #
########