#########
###   ###
#.  . ###
# # * ###
# $ $ ###
## #.$###
##  $+###
###  ####
#########