########
####   #
#### . #
#    $##
#  .$. #
##$#$ .#
## @ ###
########