#########
###  ####
###. ####
###$  $ #
# . .$#@#
#   * $.#
### # ###
###   ###
#########