########
##  ####
#@$    #
#$ $$. #
#.$.. ##
# #$* ##
# . . ##
########