########
##@ ####
##$$####
#  $  ##
#   #.##
# # #.##
#    .##
####  ##
########