#########
###   ###
#     ###
#.$ .####
##$*. ###
## $  ###
## #$####
##  +####
#########