  ####
  #  #####
### *  $ #
#   **.  #
#   * *  #
######  @#
     #####