########
## .####
##   .##
#.  # ##
# # # ##
#   $ ##
###$$###
### @###
########