########
### @###
###* ###
### * ##
#   $.##
#  . .##
## $ $##
#### * #
####   #
########