########
####   #
####$  #
#@$   ##
# $$#  #
##. . .#
##.   ##
########