#####
#   ##
# .  #
##$$ #
 #+ ##
 ####