########
###  ###
#.$    #
# # $  #
# # #.##
#@* $.##
##  ####
##  ####
########