########
#@. . ##
#   *$##
###$  ##
###    #
###$.$.#
###   ##
########