#########
##.  ####
##  $####
#    .###
# *.# ###
##$.$*###
##@$   ##
####   ##
#########