########
####  ##
#.$.*.##
#     ##
#  ##*##
#$  $@##
#   ####
##  ####
########