#########
#. ######
#. $@####
#.*$.####
# # #####
# $  ####
#  $ ####
#    ####
#########