########
### @###
###$ ###
### $###
### $ .#
### .  #
### . ##
# $$.$##
# . . ##
########