########
#####  #
##   $ #
## *$*.#
#  $ *@#
#. * * #
#  .  ##
########