#########
##### +##
#####$$##
#####  .#
##### $ #
###  $. #
### .$. #
#####   #
#########