#####
#   ###
#   * #
##  * #
 # $* #
 ###. #
   #*@#
   ####