#########
##@ #####
##$$#####
# $ $   #
# #    .#
#.  ..###
###$# ###
###  .###
#########