########
## @####
# *$  ##
#  *.. #
# $.$ .#
# *$   #
# $. ###
########