########
##   ###
##. $###
## $  ##
## ##.##
#  ## ##
#.   $@#
##  $. #
########