########
###@ ###
#  $*###
# .$ ###
#  # ###
#   .  #
## #$# #
##.  $.#
########