  ####
  #  #
###  #
#  * #
#  *@#
# $*##
## . #
 #   #
 #####