########
###    #
### ## #
### $  #
###  *##
###.*+##
#  $ $##
# .   ##
########