#########
##  #####
#     ###
#  $.$###
## #* ###
## *.@###
## $ .###
##  #####
#########