#########
###. ####
##  .####
##* *.###
#  $#@###
#  $  ###
# # $####
#    ####
#########