########
##  ####
# .   ##
# $ $.##
#.**. ##
#$ $*$ #
# @ .  #
########