########
##   ###
##$+  .#
# $ ## #
# #. $ #
#    ###
###  ###
########