########
#  .####
#  $   #
##.#$  #
##.#  ##
##+$  ##
## ##$##
##    ##
########