#########
###  ####
##  .  ##
## $$.. #
####@** #
####$  ##
####   ##
####  ###
#########