########
##. .$.#
# .$ #@#
#   ## #
#  $ $ #
##  ####
##  ####
########