#########
###@ .###
###$#$###
#  $  ###
#   $ ###
#  #  ###
## #* ###
## ...###
#########