#########
#  ######
# $$.  ##
#  ..  ##
###*# ###
###  $###
### # ###
###@  ###
#########